*****************
*****************
*****************
*****************
*****************
****.....-_.....*
****............*
****.....P......*
****............*
*****************