BBBBBBBBOUUTBBBBBBBB
B.......OUUT.......B
B..147..OUUT..147..B
B..258..OUUT..258..B
B..X69..OUUT..369..B
B.......OUUT...P...B
B.......OUUT.......B
B.......OUUT.......B
B.......OUURAG...JAA
B.......OUUUUT...OUU
B.......OUUUUT...OUU
B.......IYYYYF...IYY
B..................B
B..................B
BBBBBBBBBBBBBBBBBBBB